Key	Text
HeroSdkLoginFailed	用户账号登录失败
CommonNotOpen	暂未开放
TeamManagerCheckCaptainNil	队长不能为空
EquipLevelUpItemEmpty	请选择材料
EquipLevelUpMaxLevel	已达到等级上限
EquipLevelUpItemNotEnough	材料不足
EquipFunctionNotOpen	暂未开放
EquipBreakMax	已突破最大次数
EquipBreakMinLevel	等级不足，无法突破
EquipBreakItemNotEnough	材料不足
EquipBreakCoinNotEnough	螺母不足
EquipResonanceSelectWeapon	选择消耗武器
EquipResonanceSelectAwareness	选择消耗意识
EquipWithSpecialCharacterIdCanNotBeReplaced	专属武器不可交换使用
EquipBreakThroughPopUpAttrPrefix	每级{0}成长
EquipSuitSkillPrefix2	二件套
EquipSuitSkillPrefix4	四件套
EquipSuitSkillPrefix6	六件套
EquipResonanceNotOwnCharacter	没有这个角色不能共鸣
EquipAwakenNot	<color=#FF0000FF>绿蓝品质</color>的装备不可觉醒
EquipReformNot	<color=#FF0000FF>绿蓝品质</color>的装备不可改造
EquipAwakenMax	已觉醒到最高等级
EquipAwakenItemNotEnough	材料不足
EquipAwakenCoinNotEnough	螺母不足
EquipAutoTakeOffNotWearingEquip	当前没有可卸下的装备
EquipBreakthroughConfirmTiltle	装备突破确认
EquipBreakthroughConfirmContent	突破后提升等级，可大幅度提升属性。
EquipBreakThroughDes0	暂无
EquipBreakThroughDes1	突破1
EquipBreakThroughDes2	突破2
EquipBreakThroughDes3	突破3
EquipBreakThroughDes4	突破4
CharacterManagerItemNotEnough	材料不足
CharacterManagerCoinNotEnough	螺母不足
CharacterCheckTeamNil	队伍不能为空
CharacterNotOpen	暂未开放
CharacterMaxLevelLimit	已达等级上限
CharacterPromotePartNotEnoughCoin	<color=#FF0000FF>进阶消耗螺母 {0}</color>
CharacterPromotePartEnoughCoin	消耗螺母： {0}
CharacterPromotePartEnoughCoin02	<color=#0F70BCFF>消耗螺母： {0}</color>
CharacterGradeSufix	{0}阶
CharacterGradeSufix02	<color=#FF0000FF>{0}阶</color>
CharacterPromotePartLevelLimit	能力提升失败，角色等级不足
CharacterPromotePartItemLimit	能力提升失败，条件不足
CharacterPromotePartCoinLimit	能力提升失败，螺母不足
CharacterPromoteGradeConditionTitle	<color=#0F70BCFF>晋升需要4项能力达到：</color>
CharacterPromoteGradeTitle	进阶消耗螺母
CharacterGradeMax	已进阶到最高级
CharacterUpgradeSkillConditionTitle	条件：
CharacterUpgradeSkillConsumeTitle	需要：
CharacterUpgradeSkillConsumeSkillPoint	技能点
CharacterUpgradeSkillConsumeCoin	螺母
CostCoin	消耗螺母:
CharacterUpgradeSkillConditionLevel	角色等级达到{0}
CharacterUpgradeSkillConditionQuality	角色进化至{0}
CharacterUpgradeSkillConditionGrade	角色晋升为{0}
CharacterSkillMax	已升级到最高级
FightAssistClose	支援信号已关闭
FightAssistOpen	已向最近的小队发出支援请求
CharacterUngradeSkillCoinNotEnough	螺母不足
CharacterUngradeSkillSkillPointNotEnough	技能点不足
CharacterUngradeSkillLevelLimit	角色等级不足
CharacterUngradeSkillQualityLimit	角色品质不足
CharacterUngradeSkillGradeLimit	角色改造不足
CharacterUngradeSkillComplete	成功升级技能
CharacterUnlockSkillComplete	成功解锁技能
CharacterUnlockNewCharacter	解锁新构造体
CharacterUpgradeComplete	晋升成功
CharacterLiberateShouldFollowOrder	需先解放上一个等级
CharacterLiberateSuccess	{0}解放达成
CharacterResonanceSkillDes	等级：{0} + {1}
CharacterFullName	{0} · {1}
CharacterUnowenedIntroduce	<size=40>{0}</size>·<size=40>{1}</size><size=26>   {2}</size>
CharacterLackDps	缺少{0}名进攻型角色
CharacterLackTank	缺少{0}名装甲型角色
CharacterLackCure	缺少{0}名辅助型角色
TipTitle	提示
EquipReplaceTip	该武器已被{0}装备，继续装备会将此装备从原始角色上卸下，是否继续?
EquipPutOnNotChar	卡牌不存在
EquipPutOnEquipTypeError	强化素材不可装备
EquipPutOnSiteError	装备部位错误
EquipTakeOffNotChar	该装备未装备
EquipTakeOffWeapon	武器不能卸下
EquipWeaponMax	武器已满级
EquipChipMax	意识已满级
EquipStrengthenPreciousTipTitle	强化提示
EquipStrengthenPreciousTipContent	强化材料中包含5★或以上装备，是否继续。
EquipResonancePreciousTipTitle	共鸣提示
EquipResonancePreciousTipContent	共鸣材料中包含5★或以上装备，是否继续。
EquipResonanceWeaponRepeatTipTitle	重复共鸣提示
EquipResonanceWeaponRepeatTipContent	共鸣技能已经解锁后，再次共鸣只能更换绑定对象，是否继续？
EquipResonancePosText	位置{0}
EquipSuitPrefabCount	 <color=#ff4e4e>{0}</color>/{1}
EquipSuitPrefabCountMax	{0}/{1}
EquipSuitPrefabCurName	当前组合
EquipSuitPrefabRenameLengthError	请输入组合名称
EquipSuitPrefabSaveNotEquipIds	组合内没有装备意识
EquipSuitPrefabSaveNotName	请输入组合名称
EquipSuitPrefabSaveOverMaxNum	组合数量超过上限
EquipSuitPrefabEquipSame	已装备相同意识
EquipSuitPrefabRenameSuc	组合改名成功
EquipSuitPrefabDeleteSuc	组合删除成功
EquipSuitPrefabSaveSuc	组合保存成功
EquipSuitPrefabEquipSuc	组合装备成功
EquipSuitPrefabNum	{0}/{1}
EquipGridUsingWords	装备中
EquipGridInPrefabWords	预设中
StoryReviewTip	选项
StoryGetRewardTip	获得{0}x{1}
OnlineInstanceQuitRoom	确定退出协同作战房间？
OnlineInstanceCancelMatch	确定取消匹配？
OnlineInstanceLeastPlayer	最少需要{0}名队员
OnlineInstanceLimitPlayer	最多不超过{0}名队员
MultiplayerRoomCanNotSelectDifficulty	仅队长可选择难度
MultiplayerRoomCanNotChangeAutoMatch	仅队长可修改快速匹配
MultiplayerRoomCanNotSetAbilityLimit	仅队长可设置战力限制
MultiplayerRoomTeamHasSameCharacter	队伍中有相同角色
MultiplayerRoomRecommendAbility	推荐战斗参数{0}
MultiplayerRoomAbilityNotLegal	战斗参数不合法
DrawUseTicketToDraw	是否花费{0}{1}购买{2}张标准补给卡？
DrawDrawCountIsNotEnough	抽卡次数不足
DrawNoneMallError	已经没有可以研发的资源了
DrawNotOpen	暂未开放
DailyActiveRewardTitle	奖励详情
WeekActiveRewardTitle	周活跃奖励详情
SuitSkillTip	({0}件套装)
SettingCheckSave	当前更改尚未保存，是否保存？
SettingSave	设置已保存
TeamLevelToOpen	指挥官等级达到{0}级开启
CopyToOpen	通关关卡{0}后开启
FinishToOpen	完成{0}后开启
FunctionOpenStage	关卡  <color=#ff7e4b>{0}</color>  已开启
FunctionOpen	功能系统  <color=#ff7e4b>{0}</color>  已开启
LevelUnit	级
Draw01	本次研发综合概率如下：
Draw02	◆创世级装备：11.5%【橙色】
Draw03	◆稀有级装备：8.5%【紫色】
Draw04	◆优良级装备：30%【蓝色】
Draw05	◆材料道具：50%
Draw06	每七次研发至少有一次会出现创世级装备。
Draw101	研发规则：
Draw102	◆每消耗360张黑卡可进行一次研发
Draw103	◆当前研究院正在建设中，不代表最终品质
Draw104	◆创世级装备为最高级装备
ExtraExperience	额外{0}%经验
WeaponSkill	武器技能
ChipSkill	意识技能
ReformSkill	改造技能
LoginPhoneEmpty	请输入手机号
LoginCodeEmpty	请输入验证码
ActivateCodeEmpty	请输入激活码
LoginSignOut	是否确定登出当前账号
NetworkError	网络错误
GetServerListFail	获取服务器列表失败\n是否重试
ConnetGameServerFail	连接游戏服失败\n是否重试
MallNotOpen	暂未开放
WeaponBagFull	武器已达到上限
ChipBagFull	意识已达到上限
CharacterLevelFull	不能超过指挥官等级
CharacterSignTip	请多多指教
EquipCoinLack	螺母不足
FubenBuyCountTitle	购买挑战次数
FubenBuyCountDesc	是否花费{0}钻石购买{1}次挑战次数？
FubenPreStage	请先通关前置关卡【{0}】
Liveness	活跃度:{0}/{1}
Finish	活跃度:已完成
DifficultMode	难度:
Difficult1	普通
Difficult2	隐藏
Difficult3	据点
FubenDifficultyNormal	【{0}-{1}】普通剧情
FubenDifficultyHard	【{0}-{1}】隐藏剧情
FubenDifficultyNightmare	【{0}-{1}】据点模式
FubenNotUnlock	副本未解锁
FubenNeedLevel	指挥官等级需达到{0}级
FubenActionPointNotEnough	免疫力下降
FubenChallengeCountNotEnough	挑战次数不足
FubenChallengeResetTime	重置时间
FubenNeedComplatePreChapter	需完成该难度前置章节
PlayerLevelUp	指挥官等级提升{0}级
FightExitMsg	是否退出本次战斗?
Award	奖励
CongratulationsToObtain	恭喜获得
Zero	零
One	一
Two	二
Three	三
Four	四
Five	五
Six	六
Seven	七
Eight	八
Nine	九
Ten	十
Hundred	百
Thousand	千
TenThousand	万
AHundredMillion	亿
Diary	日
Mouth	个月
Week	周
Year	年
Day	天
Second	秒
Minute	分
Snap	折
Hour	小时
Aha	啊哈
IsExpire	已到期
Diamond	黑卡
UpperLimit	上限
Recycle	回收
Residue	剩余
Preheat	预热
Buy	购买
Success	成功
Acquire	获得
AtPresent	已拥有
ComingSoon	敬请期待
NotUnlock	未解锁
FubenMainLineSectionName	第{0}章
ComeFrom	来自
CharacterNotMoreLevel	构造体等级不能超过指挥官等级
ErrorInValidationCode	效验码错误
AssetsBuyConsumeNotEnough	{0}不足
LoginPhoneError	请输入正确的手机号
LoginCodeError	请输入正确的四位验证码
LoginActivationCodeError	请输入正确的八位激活码
MailGetRewardEmpty	没有可领取邮件
ToolMonthBefore	月前
ToolDayBrfore	天前
ToolHourBefore	小时前
ToolMinuteBefore	分钟前
FriendCount	好友数
FriendDayCharge	今日收取
FriendChargeCoin	今日螺母收获
FriendMyId	我的识别码 : 
FriendLatelyLogin	最近登录 : 
FriendOnLine	在线
FriendOffLine	离线
FriendRemoveTip	删除好友后，与该玩家的羁绊值和聊天记录都会被清除，确定删除？
FriendSelectRemoveTip	请选择要删除的好友
FriendHaveApply	已申请过好友
ChatSystemMsg	系统消息
ChatWorldMsg	广域聊天
ChatGuilyMsg	公会聊天
ChatPrivateMsg	私聊
ChatWorldNewMsg	有【<color=#34aff9>{0}</color>】条新的消息
CurrentlyHas	当前拥有:{0}
DifferentRefreshTimes	刷新次数不足
RefreshShopItemNotEnough	重置需要的物资不足
BuyNeedItemInsufficient	购买所需材料不足
CanBuy	可购: {0}
DayCanBuy	本日可购: {0}
WeekCanBuy	本周可购: {0}
MonthCanBuy	本月可购: {0}
GainCount	获得 x {0}
TimeLimit	限时
RecommendLevelDesc	推荐等级：{0}
Recommend	推荐
HotSell	热销
TimeSoldOut	距离下架：{0} 
InputChatMsgTip	请输入聊天消息 ...
SendMessageCooling	距离下次联系还有  <color=red>%d</color> s..
RefreshRecommended	刷新推荐
UseSuccess	更换成功
BuySuccess	购买成功
EmojiText	[表情]
GiftText	[礼物]
FashionNoGet	此【涂装】暂未解锁
FashionNoWay	暂时没有获取途径
CharacterLock	角色暂未解锁
ApplyForTip	无法向对方发送好友请求，请在{0}小时后再发送
ApplyButtonName1	申请
ApplyButtonName2	好友
ActiveTime	<size=26><color=#626c78>开放剩余时间：</color></size>{0}
BuyCount	<size=26><color=#626c78>可购次数：</color></size>{0}/{1}
ShopResetTimes	<size=26><color=#626c78>次数：</color></size>{0}/{1}
AlreadyFriends	对方已经是你的好友
FriendNotAddSelf	无法将自己加为好友
NewPlayerTaskGetAward	【可领奖励】
NewPlayerTaskLock	【锁定】
NewPlayerTaskFinish	【已达成】
NewPlayerTaskLockMsg	【这个挑战还不能进行】无法进入查看任务详情
NewPlayerTaskGroupLockMsg	构造体尚未与您联络
EquipReformItemDisplay	拥有:{0}
EquipSkillDesc	<size=42><color=#0F70BCFF>{0}</color></size>\n{1}
EquipReformSelectItemDisplay	x{0}
TipsEquipReformNeedSelectItem	请先选择改造的物品
EquipReformItemNotEnough	物品不足
GiftMoneySendNotReceive	你给{0}丢了一箱螺母，你们之间产生了{1}点羁绊
GiftMoneySendHaveReceive	{0}收到了你丢的{1}个螺母
GiftMoneySendOverdue	今日给{0}丢的螺母已经过期
GiftMoneyReceiveNotReceive	{0}给你丢了一箱螺母，你们之间产生了{1}点羁绊
GiftMoneyReceiveHaveReceive	领取了{0}丢来的{1}个螺母
GiftMoneyReceiveOverdue	今日{0}给你丢的螺母已经过期
TowerOpenDesc	/{0}重置
TowerTimeIsOver	已重置
TowerDowngrade	降级预定
TowerRelegation	保级成功
TowerUpgrade	进级确认
TowerStage	行
TowerTimes	次
TowerTImesStart	第
TowerStageInfo	第<color=red>{0}</color>行
TowerFriend	好友
TowerGuild	军团
TowerStranger	路人
TowerOpenAssist	开启助战
TowerCloseAssist	关闭助战
TowerStrabger	路人
TowerCannotEnter	已经达到本段位最高层
AssistDistanceDesc	距离{0}Km
AssistPlayerDefaultSign	我就是这么强大！
ShopCannotFindActiveShop	暂无活动商店
ShopActivityItemCount	{0}<size=20>/拥有</size>
ShopNoGoodsDesc	暂无商品可购买
ShopHaveNotBuyCount	超过商店可购买的数量
ShopGridCommonCount	x{0}
NoLimit	无限
HostelFloorLock	【区域未解锁】
HostelSelectChar	【点击右方选择伙伴入住】
HostelCharInWork	【执勤中的伙伴不可离开楼层】
HostelFullElectric	已满
HostelFullVitality	已满
TeamSelectError	此角色已经在编队中
ChallengeFightNumTitleCH	阶段{0}
ChallengeFightNumTitleEN	STAGE{0}
ChallengeRewardIsGetted	奖励已领取
ChallengeRewardIsTips	可领奖励
HostelMaxElectric	储存上限
HostelPerElectric	产量
HostelWorkElectric	执勤产量
HostelWorkSlot	槽位数量
HostelDeviceUp	提升到
HostelDeviceLevel	等级
HostelDeviceNeedEle	需要{0}个{1}作为能源
HostelSelectCharWork	请先选择伙伴
CharacterVitality	集中力{0}
HostelProductElectric	产出粒子
HostelSlotProduct	产出{0}
HostelWorkTime	执勤时间
TipsNeedSelectCharacterStoryStage	请先选择剧情任务
HostelWorkReward	完成生产获得
HostelPerSlot	{0}/人
HostelWorkSlotLock	执勤位未解锁
BuyChallegeCount	挑战 <color=#FF6B3EFF>{0}</color> 次
CanChallegeCount	可挑战次数: 
BuyChallegeDesc	挑战机会
BattleWinSelectStage	返 回
BattleWinAgain	再 次 挑 战
BattleWinNext	进 入 下 一 关
BattleWinMain	主 界 面
BattleWinMainCannotEnter	无法进入下一关
GraphicDownLevel	检测到当前帧数较低，是否降低画质？
FubenEmexProgress	<color=#0f70bcFF>{0}</color>/{1}
NewRoomSingleCannotSetRobot	无法编辑试玩队伍
CharacterShowLevel	{0}<color=#000000FF><size=40>/{1}</size></color>
World	世界
Team	部队
System	系统
None	无
Attack	攻击
Defense	防御
Life	生命
Blast	暴击
Score	评分
EvaMaxDes	最大值
Evaluation	评估
PutOn	装备
Obtain	获取
StorySkipDesc	是否跳过该剧情？
InputTips	请输入聊天内容......
CountDownTips	还有({0}S)可发送
Clipboard	已复制到剪贴板
WrongDate	输入日期错误
Birthday	{0}月{1}日
CopySuccess	复制成功
RecycleTips	选择中有评分较高的物品是否确认分解?
BossSingleChallengeCount	<size=58><color=#0f70bc>{0}</color></size>/{1}
BossSingleScore	讨伐值{0}
BossSingleNoNeedScore	全部获得
BossSingleScore2	当前讨伐值：{0}
BossSingleMinute	{0}分钟
BossSingleBossScore	<size=50><color=#0f70bc>{0}</color></size>/{1}
BossSingleOpenTip	高级区开放第三个Boss
BossSinglePrecentDesc	{0}<size=42>%</size>
BossSingleRankDesc	等级：{0} - {1}
BossSingleLeftTime	<size=34><color=#000000FF>距离重置还有:</color></size>{0}
BossSingleLeftTimeIos	(ios榜单)
BossSingleLeftTimeWin	(win榜单)
BossSingleLeftTimeAndroid	(Android榜单)
BossSingleLeftTimeAll	(全平台榜单)
BossSingleStamina	耐力：{0}/{1}
BossSingleNoStamina	{0}耐力值不足
BossSingleSocreReward	您的讨伐奖励已经发送到邮箱
BossSingleBossNotEnough	Boss尚未开启
BossSingleBossRankSocre	<size=22>讨伐值 </size>{0}
BossSingleLeftTimeIcon	距离重置还有:{0}
BossSingleProgress	进度：{0}/{1}
NotSelEquiping	无法选择正在装备中的部件
PleaseSelMorePart	至少选择一个物品
IsSureRecycle	回收列表中有评分高于当前装备的装备，是否确认回收？
EvaNorSuccess	鉴定成功
EvaBigSuccess	鉴定大成功
CoureDesc	完成关卡<color=#0E70BDFF>{0}</color>即可获得奖励
IsSureDelete	是否确认删除？
DorType1	内存-装甲
DorType2	风扇-装甲
DorType3	处理器-敢死
DorType4	电源-敢死
DorType5	底板-生化
DorType6	显卡-生化
OnlineInviteFriend	"{0}正在挑战{1},请求您的支援,room"
OnlineInviteLink	<a href={0}>[立即前往]</a>
OnlineKickOut	您已被踢出房间
OnlineSendWorldSuccess	发送成功
OnlineQuickStart	快速匹配已开启
OnlineQuickOver	快速匹配已关闭
OnlineCurCharacterAlreadyFight	当前角色已出战
OnlineFightSuccess	出战成功
OnlineInstanceEnterRoom	成功进入队伍
OnlineCancelReadyBeforeSelectCharacter	准备中不可修改角色
OnlineRoomOnDisconnet	与房间断开连接
BuyCountIsNotEnough	购买次数不足
SocialGiftTips	全部收取<color=#34aff8>({0}/{1})</color>
DrawTotalCount	<size=30><color=#000000FF>已研发：</color></size>{0}回
DrawCount	{0}回研发
ServerDisconnect	服务器断开连接
ServerError	连接服务器错误
HeartbeatTimeout	与服务器失去连接
LoginTimeOut	登录超时，是否重试?
FubenNotTime	副本已过期
FubenDailyIsAlreadyReset	副本已重置
FubenDailyRemainCount	剩余：{0}次   
FubenDailyOpenRemark	周{0}开放
FubenDailyOpenHint	仅在周{0}开放
FubenDailyAllDayOpen	全天开放
DailyActive	每日活跃度
WeekActive	每周活跃度
LevelActionPoint	{0}(+{1})
OnlineBossTimeOut	协同作战已刷新
FlopRewardSelect	请选择奖励
FlopRewardWait	等待确认
FlopRewardWaitClose	面板即将关闭
DrawCombination	{0}
DrawVoucherNotEnough	{0}不足
DrawBuyVoucherQuery	是否使用<color=#0f70bc>{0}</color>【{1}】购买<color=#0f70bc>{2}</color>张【{3}】
DrawOwnVoucherAmount	<size=34><color=#838383FF>拥有：</color></size>{0}
DrawResetTime	<size=40><color=#FFFFFFFF>距离重置还有:</color></size>{0}
Fract	{0}<size=30>/{1}</size>
RoomHrefDisabled	支援消息已过期
GetAssistFail	支援失效：当前未遇到其他小队。
ChatManagerNotSendCoinToNotFriend	不能给非好友发送螺母
ChatManagerGiveGiftFailedHaveGiven	已经给好友发过礼物
RoomQuit	已退出联机队伍
CharacterExpItemsUse	使用成功
CharacterPartUpGrade	突破成功
CharacterActivation	激活成功
ExpAdd	经验+{0}
BountyTaskRefreshCountNotEnough	刷新次数不足
BountyTaskAccetpTaskSuccess	接受赏金任务成功
BountyTaskRewardTipTitle	赏金任务奖励
BountyTaskTipTitle	赏金任务提示
BountyRankDescContent	每周一5:00，通过邮件发送奖励
BountyTaskTipContent	任务与段位每周1凌晨5点刷新。\n接取任务后周期内无法删除。\n每日可刷新心仪任务7次。
UiFubenCoinSkillName	{0} <color=#{1}>{2}</color>
UiFubenCoinSkillReward	上次收益 <size=42><color=#{0}>{1}</color></size>
UiFubenCoinSkillChallenge	<color=#{0}>{1}</color>
UiFubenCoinSkillDesc1	第一行文本
UiFubenCoinSkillDesc2	第二行文本
UiFubenCoinSkillDesc3	第三行文本
MissionSendSuccess	派遣成功
MissionConditionMemberLimit	派遣队伍人数不足
MissionConditionNotEnough	派遣条件不足
MissionGiveupSuccess	放弃派遣任务成功
MissionRefreshSuccess	刷新成功
MissionAutoSelectFail	当前没有符合派遣条件的构造体
MissionTeamCountTipTile	提示
MissionGiveupTaskContent	确认放弃当前任务？
MissionRefreshTaskContent	确认花费%s%s刷新任务
MissionCurContent	(当前)
MissionTaskTeamMember	要求上阵%s个角色
MissionTaskCountContent	任务数上限提升至%s
MissionTaskTeamCountContent	派遣队伍上限提升至%s
UiPanelCreateTxtExplain	投入越多货币，产出高品质家具概率越高
UiPanelCreateTxtFurnitureCoin	可投入货币     ：
UiPanelRefitConsume	消耗家具币
UiPanelRefitSelectDrawing	选择图纸
BfrtFightEchelonTitle	作战梯队【{0}】
BfrtLogisticEchelonTitle	后勤梯队【{0}】
BfrtLogisticEchelonTitleSimple	后勤 {0}
BfrtFightEchelonTitleSimple	作战 {0}
BfrtRequireCharacterNum	作战人数：{0}
BaseEquipRecycleNotSelected	请先选择装备
FightTeamConditionLimit	作战队伍不符合要求
LogisticsTeamConditionLimit	后勤队伍不符合要求
BfrtInfoTeamName	梯队{0}
BfrtRequireNum	作战梯队：{0}
BfrtRequireNum1	后勤梯队：{0} 
BfrtRequireNum2	总人数：{0}
BfrtTaskOrder	任务{0}
BfrtDeployTipContent	是否让{0}从{1}更换至{2}。
BfrtDeployTipTitle	编队提示
BfrtCharacterAbilityLimit	出战成员战斗力不符合要求
BfrtChapterProgress	{0}/{1}
BfrtChpaterLocked	未开启
BfrtChapterUnlockCondition	通关上一章节后开启
BfrtAutoTeamNoMember	当前没有符合条件的队员
WeaponLevel	{0}(共鸣+{1})
CharGradeUseItem	需要{0}:{1}
CharQuiltyLevelUp	{0}成长
CharUnlockTips	构造体： {0}
FavorabilityGetReward	获得奖励
FavorabilityGetRewardWithArgs	获得奖励{0} X {1}
FavorabilityUnlockPlotSucc	剧情【{0}】解锁成功!
FavorabilityUnlockInfoSucc	资料【{0}】解锁成功!
FavorabilityUnlockStrangeNewsSucc	异闻【{0}】解锁成功!
FavorabilityUnlockAudioSucc	语音【{0}】解锁成功!
FavorabilityAddExp	【{0}】增加{1}点信赖度!
FavorabilityPlotTitle	EP{0}
FavorabilityCurrSelected	当前
FavorabilityCast	配音：{0}
FavorabilityAudioUnlock	语音【{0}】未解锁!
FavorabilityInfoUnlock	资料【{0}】未解锁!
FavorabilityNotOwnChar	当前选中的角色未拥有!
FavorabilityStroyUnlcok	剧情【{0}】未解锁!
FavorabilityStrangeNewsUnlcok	异闻【{0}】未解锁!
FavorabilityChooseAGift	请选择一种礼物!
FavorabilityGiftNumberZero	当前要赠送的礼物数量为0!
FavorabilityRewardCollected	奖励【{0}】已经领取!
FavorabilityRewardUnlock	奖励【{0}】未解锁!
FavorabilitySetAssistSucc	设定【{0}】为助理成功!
FavorabilitySetAssistAlready	已设定【{0}】为助理!
EquipStrengthenMaxLevel	已达上限等级
EquipStrengthenCurLevel	{0}/<color=#28CFFFFF>{1}</color>
EquipLevelText	<color=#0E70BDFF>{0}</color><size=30>/{1}</size>
EquipStrengthenSuc	装备强化成功
EquipPutOnSuc	装备穿戴成功
EquipTakeOffSuc	装备脱下成功
EquipResonanceSelectCharacterTip	选择一位构造体进行同调
EquipResonanceSelectWeaponTip	消耗一件同星级武器
EquipResonanceSelectAwarenessTip	消耗一件同名意识
EquipResonanceNoWeaponTip	暂无武器选择
EquipResonanceNoAwarenessTip	暂无意识选择
CustomUiTip	<color=#ffffff>点击需要调整的按钮，拖动调整位置</color>
CustomUiConflict	<color=#ffffff>有按钮重叠，请重新检查</color>
CustomUiSaved	<color=#ffffff>方案保存成功</color>
CustomUiUnsave	按键方案尚未保存，确定要退出吗？
CustomUiSchemeCustomName	自定义方案
AwarenessDetailTitle	意识属性
WeaponDetailTitle	武器属性
WeaponSkillBtn	武 器 技 能
SuitSkillBtn	套 装 技 能
WeaponStrengthenTitle	选择消耗武器
AwarenessStrengthenTitle	选择消耗意识
EquipIsLock	装备处于锁定状态
EquipIsBindCharacter	专属装备角色不可替换
EquipResonanceSelectSlot	共鸣技能槽{0}
EquipPutOnSpecialCharacterIdNotEqual	此装备为{0}·{1}专属
ArenaTeamKickOutMemberConfirm	是否将【{0}】请离队伍？
ArenaTeamLeveTeamConfirm	是否退出当前队伍？
ArenaTeamAlreadyHaveTeam	您已有队伍，无法申请
ArenaTeamCanNotInvite	您没有队伍，无法邀请
ArenaTeamIsFull	本队伍已满3人，无法在邀请
ArenaTeamIsNotCaptain	只有队长能邀请别人
ArenaActivityBeginCountDown	距离开启时间
ArenaActivityResultCountDown	距离下次活动时间
ArenaActivityEndCountDown	进行中：{0}
ArenaOverDescription	结算期
ArenaTeamDescription	组队期
ArenaFightNotJoinDescription	任务奖励已刷新
ArenaFightJoinDescription	战斗期
ArenaWaveRate	波动指数{0}
ArenaPlayerLevelRange	等级段：{0}-{1}
ArenaActivityUpRegion	晋级区
ArenaActivityKeepRegion	保级区
ArenaActivityDownRegion	降级区
ArenaActivityUpRegionColor	<color=#20bb61>晋级区</color>
ArenaActivityKeepRegionColor	<color=#2086bb>保级区</color>
ArenaActivityDownRegionColor	<color=#bb204f>降级区</color>
ArenaActivityNotUpRegionDesc	该组小队不会晋级
ArenaActivityNotDownRegionDesc	该组小队不会降级
ArenaActivityNotKeepRegionDesc	该组小队不会保级
ArenaActivityUpRegionDesc	该组{0}-{1}名晋升至高一级小队
ArenaActivityKeepRegionDesc	该组{0}-{1}名保留在当前小队
ArenaActivityDownRegionDesc	该组{0}-{1}名降低至低一级小队
ArenaActivityConfirmUnlockArea	是否解锁【{0}】？\n今日剩余解锁次数：{1}（每日重置）
ArenaActivityUnlockCountNotEnough	今日已经没有解锁次数，请明天再试
ArenaActivityLordIsEmpty	虚位以待
ArenaActivityStage	第{0}区域
ArenaActivityResultUp	恭喜你在纷争战区提升到 <color=#0f70bc><size=60>{0}小队</size></color>
ArenaActivityResultDown	很遗憾你在纷争战区下降至 <color=#0f70bc><size=60>{0}小队</size></color>
ArenaActivityResultKeep	你在纷争战区英勇奋战保留在 <color=#0f70bc><size=60>{0}小队</size></color>
ArenaActivityStrategyContent	活动时间：\n第一期：周日18点30分~周三18点整\n第二期：周三18点30分~周日18点整\n\n玩法说明：纷争战区是在不同战区中通关区域获得积分的玩法，每期都会更换区域的敌人种类和属性\n\n区域说明：每个战区3个区域均可重复挑战，前2个区域通关时间越短、己方剩余生命越多，则积分越高；第3个区域无限刷怪，限时内对敌人造成的伤害越高，己方剩余生命越多，则积分越高。\n\n段位说明：每期活动数名指挥官会匹配在一起，根据积分进行排名，排名前几名的指挥官会在下期晋升到更高一级段位\n\n组队说明：准备时间可自由组队，战斗开始后不满3人的队伍会自由分配，队员积分总和能争夺队伍排名。
ArenaActivityAreaIsNotOpen	此战区本周期内锁定，无法挑战
ArenaActivityPoint	 {0}
ArenaMaxSingleScore	最高可获取{0}分
ArenaMaxSingleNoScore	最高分无上限
ArenaMaxAllScore	{0}<size=40>MAX</size>
ArenaMaxAllHistoryScore	{0}<size=30>MAX</size>
ArenaGrouplScore	第 {0} 波
ArenaTeamInvitError	组队需等级区与段位相同
ArenaTeamInvitTip	状态刷新可能存在延迟
ArenaTeamLevelError	组队需等级区与段位相同
ArenaTeamChallengeError	该玩家尚未进入本期战区
ComeAcrossTips	每天可偶遇3次，24点重置次数
ComeAcrossStart	开始！
ComeAcrossRight	<color=#8cfa7a>正确！</color>
ComeAcrossWrong	<color=#fd6e6e>错误！</color>
ComeAcrossEnd	%s秒后自动退出
ComeAcrossTimeout	<color=#fd6e6e>时间到！</color>
NewbieDayTab1	第0{0}天
NewbieDayTab2	第{0}天
NewbieDayUnlock	目标尚未开启
ComeAcrossNext	%s秒后开始下一题
ComeAcrossGameEnd	<color=#2abdfc>游戏结束</color>
FavorabilityStorySectionName	第{0}章
EquipCapacityDes	拥有的武器
AwarenessCapacityDes	拥有的意识
SuitCapacityDes	拥有的套装
MaterialCapacityDes	拥有的道具
FragmentCapacityDes	拥有的碎片
DecomposeTitle	分解预览
ConverseTitle	转化预览
SellTitle	出售预览
DecomposeConfirmTip	分解返还70%左右所有培养材料（返还不包括共鸣材料）
DecomposeConfirmTitle	装备分解二次确认
SellConfirmTip	选中物品为高品质物品
SellConfirmTitle	物品出售二次确认
ItemDeadLine	（{0}后过期）
SelectGiftCount	可自由选择{0}个奖励
SelectGiftMaxCount	可选礼包选满了
PrequelChapterTimes	次数：{0}
TrialIllustration	玩法分为前段与后段，每段各5关。\n关卡可复刷，复刷没有任何奖励。\n每通关5关即可领取装备奖励。
AwarenessTfPos	{0}号位
AwarenessTfMaterialMainError	请先选择主要材料
AwarenessTfMaterialError	材料不足
AwarenessTfConfirmTitle	重要提示
AwarenessTfConfirmContent	装备改造后将保留当前等级。
AwarenessTfConfirmContentResonance	当前装备带有共鸣技能，改造后将会清空！
AwarenessTfMaterialSelectError	已达到选择上限
PrequelChallangeTab	挑战模式
PrequelCompletion	完成度：{0}/{1}
TrialFinish	已完成关卡
TrialUnLock	未解锁关卡
AbilityInsufficient	战力不足
AvgInsufficient	目前关卡极度危险，建议{0}个上阵构造体战力提升至{1}，是否强行挑战
Insufficient	目前关卡极度危险，建议提升构造体战力至{0}，是否强行挑战
AbilityCurrentTips	{0}(当前战力：{1})
AvgAbilityTips	{0}(平均战力：{1})
RenameLengthError	昵称不能为空
DrawRuleHint	占<color=#36cdff>{0}</color>{1}出率<color=#36cdff>{2}</color>
DrawBottomTimes	剩余<color=#36cdff>{0}</color>回必出
AbilityCurrentSufficientTips	<color=#0e70bd>{0}(已有最高战力：{1})</color>
AbilityCurrentInSufficientTips	<color=#e84c4c>{0}(已有最高战力：{1})</color>
TrialForPro	前段进度{0}/{1}
TrialBackEndPro	后段进度{0}/{1}
TrialName	意识营救战
TrialLevelFinish	解锁意识{0}/{1}
NoticeTag1	活动
NoticeTag2	补给
NoticeTag3	重要
NoticeTypeTitle2	游戏公告
ShopAutoRefresh	<size=26><color=#626c78>自动刷新：</color></size>
PrequelUnTrigger	未完成触发条件
DrawResetTimeShort	{0}
TrialNoFinishTips	请先通过阿斯麦
NoActivities	当前没有活动公告
NoInGameNotice	当前没有公告
ItemCanConvert	溢出
DrawCardResetTime	<size=28><color=#AFAFAFFF>距离重置还有:</color></size>{0}
ArenaActivityTeamStatusWrong	组队功能暂未开放，请于组队期进行操作
ArenaActivityStatusWrong	当前状态无法执行此操作
EmailExpireTime	剩余时间：{0}
EmailForever	剩余时间：永久
ArenaActivityStatusChange	竞技场状态已经改变
Rank1Color	<color=#ff3f3f>{0}</color>
Rank2Color	<color=#0e70bd>{0}</color>
Rank3Color	<color=#30aa17>{0}</color>
RankOtherColor	<color=#636363>{0}</color>
FriendApplySuccess	您已经向对方发送好友申请
FrienRefreshSuccess	好友刷新成功
FriendAgree	已同意好友请求
FriendRefuse	已拒绝好友请求
FriendThrowSuccess	群体投掷成功
AutoFightStageMainType	主线剧情
AutoFightStagePrequelType	间章挑战
DormAllDesc	全选
DormFurnitureRecycelNull	尚未选择家具
DormFurnitureRecycelComfirm	确认回收选中家具
DormFurnitureRecycelUsingComfirm	有家具正在使用确认继续回收
DormFurnitureRecycelUsingTip	无法回收使用中的家具
DormFurnitureNotSuit	无套装属性
DormCharacterLevel	阶段{0}
DormCharacterHpRecover	当所在宿舍达到{0}{1}{2}伙伴每小时恢复体力{3}
DormCharacterHpLeft	<color=#0E70BD><size=40>{0}</size></color>/{1}
DormCharacterHpSpeed	每小时恢复{0}点体力
DormCharacterMoodSpeed	每小时恢复{0}点心情
DormFurnitureEffectDesc	此家具所在宿舍的构造体的{0}增加{1}点，{2}不生效
DormFurnitureEffectDescNull	无特殊效果
DormFurnitureSelectNull	尚未选择
DormFurnitureScoreDesc	<size=24>{0}</size>{1}
DormFurnitureAllTypeRepeatClickHint	请选择一个类型
DormSelectAllCount	全部选择<size=38><color=#0E70BD>{0}</color></size>
DormSelectCount	已筛选<size=38><color=#0E70BD>{0}</color></size>
DormLock	解锁
DormPerson	人员
DormWork	执勤
DormLove	超爱
DormLike	喜好
DormTotalScore	总评分
DormTask	任务
DormDes	说明
DormWareHouse	仓库
DormReName	改名
DormFieldGuilde	图鉴
DormMyFriend	我的好友
DormMember	舰队成员
DormStranger	未知访客
DormWorking	执勤中
DormWorked	完成执勤
DormBase	基础
DormJapanese	日系
DormPunk	朋克
DormDesSecond	宿舍舒适度由：美观、舒适、实用组成，不同的伙伴喜欢的属性各不相同。\n进入仓库可查看构造体/侵蚀体喜欢的属性。舒适度可提升构造体的体力恢复速度（ps.伙伴喜欢的属性高的话，还可以恢复心情值）。\n初始解锁一间宿舍，可使用家具币不断解锁其他宿舍。每个宿舍最多放置3个伙伴。\n\n家具可通过商店购买（ps.商店内的家具属性固定）/建造/改装获取。\n建造仅可建造“基础套”家具，但可以自定义家具属性。\n改装可以通过消耗图纸，更改家具的样子（还会出现特殊效果）。\n\n心情值很高的伙伴会定期赠送指挥官礼物，不断提高伙伴的心情值吧！
DormDesWork	通过消耗伙伴体力进行执勤，可获取家具币。\n每次执勤会消耗伙伴几乎全部的体力。\n体力与可获取家具币的比例成固定值。\n执勤的座次数量可通过解锁宿舍房间提升。\n每日凌晨5:00的执勤座次。
DormChinese	宿舍
DormReNameSuccess	改名成功
DormReNameFail	改名失败
ExploreChapterName	{0}章记录
ExploreNotOpenError	请先通关前面章节
DormOnline	在线
DormOffline	离线
DormNoCount	没有宿舍
DormBagFurnitureCount	<size=26><color=#000000FF>拥有的家具   </color></size><size=52><color=#0f70bc>{0}</color></size>
DormBagEmneyCount	<size=26><color=#000000FF>拥有的侵蚀体   </color></size><size=52><color=#0f70bc>{0}</color></size>/{1}
DormBagCharacterCount	<size=26><color=#000000FF>拥有的构造体   </color></size><size=52><color=#0f70bc>{0}</color></size>/{1}
DormBagDraftCount	<size=26><color=#000000FF>拥有的图纸   </color></size><size=52><color=#0f70bc>{0}</color></size>
DormHight	<color=#{0}>{1}(高)</color>
DormFondleCount	爱抚次数  <color=#34AFF8FF><size=66>{0}</size></color>/{1}
DormFondleRecovey	{0}恢复中
DormMiddle	<color=#{0}>{1}(中)</color>
DormHightDescription	<color=#0f70bcff>超爱</color>
DormMiddleDescription	<color=#0f70bcff>喜爱</color>
BaseEquipNeedLevel	指挥官等级需达到{0}级
BaseEquipType1	进攻专属
BaseEquipType2	装甲专属
BaseEquipType3	辅助专属
ExploreBuffUnlock	通关{0}解锁
ExploreBuffUnlockSeparate	、
ExploreRewardError	奖励已领取
ExploreRewardTitle	奖励详情
ExploreExplain	完成章节所有的关卡后，可解锁章节奖励，并解锁下一章节。\n\n每个章节构造体的体力有限，注意构造体的使用。\n\n构造体的体力进入新章节后重置。
FurnitureDefaultDraft	Assets/Product/Texture/Atlas/UiFurnitureBuild/FurnitureJia.png
FurniturePreviewIcon	Assets/Product/Texture/Atlas/UiFurnitureBuild/FurnitureWeizhi.png
FurnitureChooseFurniture	请选择一个家具
FurnitureChooseDraft	请选择一个图纸
FurnitureNotMatchDraft	该图纸不能改装当前选中的家具
FurniturePlaceNotCorrect	请先摆放好家具
FurnitureOutOfLimit	不能放置家具，该类型的家具已经达到上限
FurnitureChooseAType	请选择一个家具类型
ExploreBannerProgress	最新章节：
ExploreBannerProgressEnd	全部完成
FurnitureDescription	调整投入的家具币比例，可控制舒适度属性分布。\n投入的家具币越多，随机到的属性总值越高。
DormBuild	建造
DormWorkTips	选择执勤位不得超过最大数量
DormWorkCount	执勤位 <size=66><color=#0f70bc>{0}</color></size>/{1}
DormEmptyTips	宿舍没有人
DormActiveStateTips	此宿舍没有激活
DormActiveTips	是否花费{0}个{1}激活该宿舍（宿舍币商店购买）
FurnitureInvestment	至少投入<color={0}> {1} </color>家具币，最多投入<color={2}> {3} </color>家具币
DormActiveSuccessTips	宿舍激活成功
DormEnterTips	是否进入{0}宿舍
DormVisitStrangeEmptyTips	没有访客
DormVisitFriendEmptyTips	暂无好友 
FurnitureSelectAType	请先选择一个家具类型
DormPersonMoveTips	是否将{0}移到{1}宿舍
DormRewardText	奖励已领取
FurnitureSaveSuccess	家具保存成功
FunitureCannotCompound	选中的图纸不能合成家具
FurnitureTips	提示
FurnitureIsSave	是否要保存修改？
DormWorkNoRewardTips	无可收取奖励
ExhibitionNotObtainCharacter	尚未获取该构造体
ExhibitionTaskNotFinish	领取条件还未达成
ExhibitionUnknownCharacter	暂无该构造体信息
ExhibitionExplain	收集到的构造体会点亮对应的构造体头像。\n提升了构造体战力、等级后，可以解锁构造体专属奖励。
DormFullPersonTips	超过宿舍最大数量
DormVisitorFirend	是否添加{0}为好友
FavorabilityGetWay	偶遇可获得礼物
BossOnlineProcess	拾荒者剩余：{0}
BossOnlineKillCount	击杀构造体：{0}
BossOnlineConsumeTips	拾荒者已消耗完毕，结算时将失去【拾荒者奖励】选择权，是否继续。
BossOnlineNotUnlock	请完成上一难度关卡
BossOnlineConsumeFinish	拾荒者已消耗完毕
BossOnlineInvade1	终于见面了呢
BossOnlineInvade2	在天上的人类们
BossOnlineInvade3	接下来的表演估计会很精彩吧
BossOnlineInvade4	准备好承受守林人的怒火了吗
BossOnlineInvade5	那么，有请主角上场
ActivityBranchNormalProcess	进度：{0}/{1}（普通）
ActivityBranchLeftTime	活动剩余：{0}
ActivityBranchDifficultProcess	进度：{0}/{1}（挑战）
ActivityBranchCurLevelDes	{0} - {1}级
ActivityBranchLevelDes	{0} - {1}级
ActivityBranchFightLeftTime	作战时间剩余：
ActivityBranchShopLeftTime	兑换时间剩余：
ActivityBranchChallengeBeginTime	挑战开启时间：{0}
PayAcceptTips	充值已受理，请耐心等待
PaySuccess	充值成功
PayFail	充值失败
ActivityMainLineEnd	活动已结束
ActivityBranchFightEnd	战斗时间已结束
DormCaressTips	伙伴放于床上有助于恢复心情
FurnitureCleanRoom	是否全部收起？
FurnitureRevertRoom	是否重置修改
DormReNameTips	名字中不能有空格
ActivityAlreadyOver	活动已结束
DormPersonTxt	人员
DormRemouldTxt	装扮宿舍
DormMenTxt	菜 单
ActivityBossSingleProcess	进度：{0}/{1}
ActivityBossSinglePreStage	通关前置关卡{0}
ActivityBossSingleFightEnd	战斗时间已结束
DormVisitNameStyle	{0}<size=28>（{1}）</size>
DormFieldGuildeCountText	<size=52><color=#0f70bc>{0}</color></size>/{1}
DormWorkRefreshTime	每日<size=66><color=#0f70bc>{0}</color></size>刷新
DormWorkVitNotEn	执勤体力不足
DormWorkPosUnLockTips	请开启新宿舍
FurntiureBuildCreateCH	制造
FurntiureBuildCreateEN	基础家具
FurnitureBuildRefitCH	改装
FurnitureBuildRefitEN	家具改造
FurnitureRefitScore	评分   <size=26><color=#000000CC>{0}</color></size>
ActivityBranchNotOpen	活动未开启
ActivityBranchOver	活动已结束
ActivityBossSingleNotOpen	活动未开启
ActivityBossSingleOver	活动已结束
ActivityBossOnlineOver	"每天中午11:00-14:00,晚上20:00-23:00开启"
FurnitureWholeText	全部
FurnitureAddType	添加类型
MaxRecommendFight	需有角色战力高于
AvgRecommendFight	需角色战力均高于
RecommendFight	推荐战力
NoneBfrtMode	暂无据点模式
CancelText	取消
DormWorkStart	开始执勤
DormFurnitureName	{0} <size=28>{1}·{2}</size>
EquipResonanceExplainTitle	装备共鸣说明
EquipResonanceExplain	6★武器共鸣-\n效果：获得指定武器技能\n消耗：任意6★武器1件\n备注：绑定构造体\n5★武器共鸣-\n效果：获得指定2条基础属性\n消耗：任意5★武器1件\n\n6★意识共鸣-\n效果：随机获得技能池中任意1个技能，等级可叠加\n消耗：同套装意识1件\n备注：绑定构造体\n5★意识共鸣-\n效果：随机加强2条属性\n消耗：同套装意识1件
EquipResonanceConsumeItemLack	没有足够的共鸣道具。
EquipStrengthenBtnTxt1	强化
EquipStrengthenBtnTxt2	提升等级
EquipBreakthroughBtnTxt1	突破
EquipBreakthroughBtnTxt2	等级上限
PusrchaseBuyTips	将使用<color=#fff100>{0}元</color>购买【{1}】，是否确定
PurchasePayText	充值
PurchaseLbText	l礼包
PurchaseHK	黑卡
PurchaseYK	月卡
ReportFinish	已举报该玩家
ReportError	您已举报成功，{0}秒后才能再次举报
PurchaseYKExChangeTab	兑换
PurchaseYKShopTab	黑卡商店
ReportSelectTypeError	请选择一种举报类型
ReportTemplate	该玩家在【{0}】中疑似作弊。
SetPlayerInfoError	请求过于频繁，请稍后再试
SetAppearanceSuccess	保存成功
PurchaseAddHide	*****
PurchaseRestTypeDay	每日限购{0}/{1}
PurchaseRestTypeWeek	每周限购{0}/{1}
PurchaseRestTypeMonth	每月限购{0}/{1}
PurchaseRestTypeInterval	每隔{0}天限购{1}/{2}
PurchaseExchangeTips	购买额外赠送{0}{1}
PurchaseFirstPayTips	首次购买额外赠送{0}{1}
PurchaseAddPayDes	累计购买虹卡可领取对应奖励。
PurchaseYKDes	月卡购买后，持续30日，每日5:00，可领取100黑卡。\n月卡最多购买2张，超过2张后无法购买。\n购买后可立即获取300黑卡。
SaveShowSetting	是否保存展示设置修改？
AreanaStaSocre	积分：{0}
ArenaRankDesc	（每30分钟更新一次）
ArenaHighDesc	{0}<size=32><color=#000000FF>（本期历史最高）</color></size>
ArenaConnotPassTip	通关前置关卡后开启
IsNotFriend	未成为好友
PurchaseBuySuccessTips	购买成功
BagNoOverFragment	暂无溢出的碎片
DormWorkNoPerson	未选择角色
DormVisitBtn	随机访问
FavorabilityMaxLevel	信赖等级已经达到最高
DormReNameErrorText	宿舍名称不能留空
DormWorkNoPerson1	无可执勤人员
PurchaseLiSellOut	礼包已售罄
PurchaseSetOffTime	{0}后下架
PurchaseSetOnTime	{0}后上架
PurchaseBuyNotSet	还没有上架
PurchaseYKBuyLimt	月卡限购：{0}/{1}
PurchaseYKSurplusDay	剩余天数：{0}天
PurchaseYKMaxDay	最大累计天数：{0}/{1}天
PurchaseYKGetTips	立即获得<color=#ff8338><size=30>{0}</size></color>{1}
PurchaseYKDayGet	连续{0}天每天可获得<color=#59f5ff>{1}</color>{2}
FavorabilityMaxGiftNum	已经达到最大值
PurchaseYKBuyText1	<color=#ffea00>{0}</color>{1}          购买
PurchaseYKBuyText2	点击续购
PurchaseYKBuyText3	不可续购
PurchaseYKBuyText4	不限购
PurchaseGiftValitimeTips1	礼包即将过期
PurchaseGiftValitimeTips2	多个礼包即将过期
BossSingleCannotReward	尚未达到可领取积分
PurchaseNotBuy	无法进行购买
BossSingleRepeartDesc	重复挑战boss仅刷新最高讨伐值.\n讨伐值不会累计。
BossSingleAutoFightDesc1	无记录保存
BossSingleAutoFightDesc2	{0}难度无自动战斗
BossSingleAutoFightDesc3	<color=#0e70bd>{0}</color>/{1}
BossSingleAutoFightDesc4	{0}<size=26><color=#000000FF>/{1}</color></size>
BossSingleAutoFightDesc5	<color=#0e70bd>{0}</color>/{1}
BossSingleAutoFightDesc6	<color=red>{0}</color>/{1}
BossSingleAutoFightDesc7	构造体无耐力，无法替换记录
BossSingleAutoFightDesc8	挑战次数不足，无法替换记录
BossSingleAutoFightDesc9	替换记录将消耗阵容耐力及每日次数各1点，是否挑战
BossSingleAutoFightDesc10	（最高可获取{0}）
BossSingleAutoFightDesc11	替换记录将消耗阵容耐力及每日次数各1点，并将讨伐值更新为保存记录的80%，是否挑战
BossSingleAutoFightDesc12	自动战斗讨伐值低于目前讨伐值，无法自动战斗
DrawNotEnoughError	您的货币不足
CdKeyIsEmpty	请输入兑换码
MaxCurRecommendFight	(当前角色最高战力{0})
AvgCurRecommendFight	(还有{0}个角色未达到)
TaskLeftHour	剩余<color=#0e70bd> {0} </color>小时
TaskLeftMin	剩余<color=#0e70bd> {0} </color>分钟
TaskBeginHour	距离开始<color=#0e70bd> {0} </color>小时
TaskBeginMin	距离开始<color=#0e70bd> {0} </color>分钟
FightConditionError	未达到关卡开始条件
TaskStateUnopen	未开启
TaskStateOverdue	已过期
TaskStateSkip	前往
PurchaseDirGet	直接获得
PurchaseFreeText	免费
PurchaseLBSettOff	下架了
BattleLoseActorNum	投入构造体：{0}
PurchasePayGetText	购买额外赠送{0}{1}
BossSingleAutoSuccess	自动战斗成功
DormDrawNoOpenTips	卡池未开启
DormWorkText	执勤
DormPersonText	人员
DormDrawText	研 发
DormTaskText	任务
DormShopText	商 店
DormWareHouseText	仓 库
DormBuidText	制 造
BossSingleReslutDesc	目前讨伐值已超过历史最高，是否取消
DormDisable	宿舍未开放
PurchaseLBBuySuccessTips	购买成功
PurchaseSettOff	礼包已下架
DormNoRoomsTips	无可切换宿舍
DormComfortLevelTips	提升伙伴喜欢的舒适度属性，可增加体力/心情恢复速度
ConfirmText	确定
FurnitureColorS	#daa10d
FurnitureColorA	#a029c9
FurnitureColorB	#0e70bd
FurnitureColorC	#42a306
FurnitureQualityS	S
FurnitureQualityA	A
FurnitureQualityB	B
FurnitureQualityC	C
DormWorkingText	执勤中
DormNoPerson	无构造体
DormWorkSeleCount	执勤位 <size=42><color=#0f70bc>{0}/{1}</color></size>
GradeStarNum	<size=50><color=#0f70bc>{0}</color></size>/{1}
FurnitureCreateSuccess	建造成功
FurnitureRefitSuccess	改造成功
MainFubenProgress	{0}%
DormTaskDText	宿舍成就
DormTaskNText	成就任务
DormTouchDesc	来回抚摸
DormTouchTimeOut	<color=#0E70BDFF>{0}</color>秒后可继续抚摸
FurnitureMaxCoin	已达到最大值
FurnitureColorAttrA	#ff8a8f
FurnitureColorAttrB	#ffc259
FurnitureColorAttrC	#87afff
DormWorkVitTxt	体力<color=#000000FF><size=32>{0}/{1}</size></color>
BossSingleDesc	可挑战游戏中各大boss，boss每次随机刷新3只（初级区2只）。\nboss以α、β、γ组区分，并进行刷新。\n击杀boss可获取讨伐值，当讨伐值达到一定值后，自动领取讨伐值奖励。\n每周一结算排名奖励，根据当前的排名情况发送奖励。\n当角色耐力为0时，无法挑战未通关关卡，角色耐力每次重置时恢复。\n每日仅可挑战boss4次。\n使用自动战斗可还原最高纪录的80%。\n自动战斗将会扣除记录中编队成员耐力，并消耗当日次数。
BossSingleAutoFightDesc	使用自动战斗可还原最高纪录的80%。\n自动战斗将会扣除记录中编队成员耐力，并消耗当日次数。\n自动战斗刷新周期内可使用5次。
BossSingleAutoFightRateDesc	该处讨伐值为原记录的<color=#0e70bd>{0}</color>
BossSingleAutoFightCount2	自动作战       {0}/{1}
BossSingleAutoFightCount1	自动作战
BossSingleAutoFightCount3	自动作战次数不足
ChatNotAllowed	(〃'▽'〃) 
DormVilityTxt	<color=#FFFFFFFF>体力: <size=20>{0}/{1}</size></color>
FurnitureZeroCoin	家具币不足
TaskStoryNoTask	已完成当前剧情任务
InTeamCantLookExhibition	联机房间中不能进入构造体军团
InTeamCantLookDorm	联机房间中不能进入宿舍
DormNullFurniture	暂无家具
DormNullEnmey	暂无侵蚀体
DormNullCharacter	暂无构造体
DormNullDraft	暂无图纸
LoginNetworkError	登录网络错误
LoginHttpError	登录网络错误
DormVitalityRecovery	体力恢复 <color=#0E70BDFF>+{0}/h</color>
DormMoodRecovery	心情恢复 <color=#0E70BDFF>+{0}/h</color>
DormNextRecovery	下级条件
DormMaxRecovery	顶级
DormNextRecovery2	下级效果
DormVitalityRecovery1	体力恢复 <color=#B04141FF>-{0}/h</color>
DormMoodRecovery1	心情恢复 <color=#B04141FF>-{0}/h</color>
DormRecovery1	<color=#0E70BDFF>{0}</color>
DormRecovery2	<color=#B04141FF>{0}</color>
EquipStrengthenAutoSelectEmpty	暂无可选择装备
DayOfGetMedal	嘉奖日：{0}
MedalNumber	全球第{0}枚
AccumulateMonyDes	累计购买虹卡{0}
PurchaseLBRewardTips	持续奖励通过邮件发放
ChangeNameLimitHour	改名冷却时间还剩 {0} 小时
ChangeNameLimitHourMin	改名冷却时间还剩 {0} 小时 {1} 分钟
TaskLeftDay	剩余<color=#0e70bd> {0} </color>天
TypeItem	道具
TypeCharacter	构造体
TypeWeapon	武器
TypeWafer	意识
TypeFashion	涂装
TypeFurniture	家具
TypeHeadPortrait	头像
ToOtherThing	(已化为{0})
DrawLogCpunt	仅显示最近{0}条记录
DrawLogTittle	获取途径
FightQualityLowest	偏低
FightQualityMiddle	中等
FightQualityLow	一般
FightQualityHight	高
FightQualityHightest	最佳
ActivityBriefTotalTime	活动时间：{0}-{1}
ActivityBriefFightTime	作战时间：{0}-{1}
ActivityBriefShopTime	商店时间：{0}-{1}
ActivityBriefLeftTime	剩余{0}
ActivityBriefShopLeftTime	（商店剩余：{0}）
ActivityBriefTaskLeftTime	（任务剩余：{0}）
ActivityBriefNoTask	当前暂无任务
ActivityBriefMainlineNotInTime	活动未开启
ActivityBriefTaskMissionInfo	任务详情
ActivityBriefTaskDesc	可通过以下途径获取【空间作战日志】\n\n质量流失：关卡首通奖励（普通/挑战）\n黑闪：关卡首通奖励\n日志奖励：部分任务获取
ActivityBriefPrequelNotInTime	活动未开启
ChannelLabel	频道
ChannelNumberLabel	（{0}人）
ChannelChanged	进入 [ <color=#78e1ff>{0}</color> ] 频道
DrawNewHandCount	当前次数：{0}
PurchasePayFirstGetText	首次双倍
BfrtStatePassed	已占领
BfrtStateNotPassed	占领中
FurnitureBuildingListFull	家具制造队列已满
SetInputStart	请输入按键(支持组合按键)
SetInputFirstKey	(松开即可录入)
FurnitureBuildStart	开始建造家具
EquipResonanceConsumeItemCount	消耗X{0}
DormVistorFriend	好友列表
DormVistorStranger	访客列表
UseBattery	请选择血清组
RecActPoint	({0}后恢复1毫升血清)
Forever	永久
DormReNameErrorNoChange	宿舍名称与之前相同
AutoFightDialogTitle	自动作战
AutoFightDialogDescription	可获得对应等级的资源副本中50%-80%性价比的资源材料。
TaskDoNotFinish	任务未完成
TaskAlreadyFinish	奖励已领取
DrawResetTimeActivity	<size=40><color=#FFFFFFFF>活动结束剩余:</color></size>{0}
DrawResetTimeOldActivity	<size=40><color=#FFFFFFFF>活动结束剩余:</color></size>{0}
DisableJoystickError	教学关卡暂不支持手柄模式
FubenDialogTitle	行动说明
MailCountText	容量:<size=40><color=#0e70bd>{0}</color></size>/{1}
SetJoyStickSuccess	设置成功
SetJoyStickError	设置失败，有重复按键
SignLengthError	签名不能为空
PurchaseSettOut	已售罄
HideStageIsOpen	隐藏关卡[{0}]已开启
ItemOverLimit	超过储存上限的物品已发送至邮箱
OverLimitCanNotUse	使用后血清数量将会超出上限，暂无法使用
FunctionalMaintain	功能维护中
MaxNameLengthTips	名字长度超过{0}个字符
DormNameMaxNameLengthTips	宿舍名字长度超过{0}个字符
MaxSignLengthTips	签名长度超过{0}个字符
DormScoreAttrADes	<size=28><color=#AD3434FF>{0}</color></size>
DormScoreAttrBDes	<size=28><color=#D58216FF>{0}</color></size>
DormScoreAttrCDes	<size=28><color=#0A77b9FF>{0}</color></size>
FestivalNotInActivity	活动已结束
DormWorkNoMoodTips	心情值不足，无法使用代工
DormDaiGongWarnTips	无法一键代工
DormTxtDaigongDes	消耗<color=#0f70bc>60</color>点心情值寻找代工，可额外获得<color=#0f70bc>10</color>家具币
BatteryLeftTime	血清组剩余时间：{0}
TimeLimitItemLeftTime	(物品过期：{0})
MailBoxIsFull	邮箱已满，以防溢出物品邮件覆盖原有邮件请先清理邮箱后再行操作
WaferBoxIsFull	意识仓库已满，请先清理仓库后再行操作
WeaponBoxIsFull	武器仓库已满，请先清理仓库后再行操作
WaferBoxWillBeFull	意识仓库将超过上限
WeaponBoxWillBeFull	武器仓库将到达上限
ItemBoxWillBeFull	该道具的持有数将到达上限
ActivityBabelTowerNotInTime	活动未开启
ActivityBabelTowerOver	活动已结束
BabelTowerNoneFight	巴别塔计划挑战阶段已经结束
BabelTowerNoneOpen	巴别塔计划已经全部结束
BabelTowerNotEnoughScore	{0}分数达到{1}开启
BabelTowerCurMaxScore	(最高{0})
BabelTowerLeftTimeDesc	剩余时间：
BabelTowerNoneCharacter	当前没有构造体可以出战
BabelTowerLevelDesc	Lv:{0}
BabelTowerResetDesc	清除记录
BabelTowerIsResetDesc	清除记录后，将会清除本关获得的战略等级，同时解锁已被使用的角色\n是否清除关卡【{0}】的记录
BabelTowerCharacterLock	出战阵容中有构造体已被锁定
BabelTowerPleaseSelectALeader	需要选择一位构造体作为队长
BabelTowerPassLastGuide	通关上一等级阶段解锁
BabelTowerGuideStageCanntSelect	当前目标战略选项已被锁定
BabelTowerActivityTimeLeft	活动时间剩余：
ResidueStockText	库存：{0}
AlreadyobtainedCount	<size=40><color=#0f70bc>{0}</color></size>/{1}
PurchaseLimitBuy	限购{0}/{1}
GachaIsNotOpen	功能尚未开启
GachaIsClose	功能已关闭
GachaIsNotEnough	奖励库存不足
BabelTowerStageResetSucceed	关卡【{0}】清除记录成功
BabelTowerStageWipeOutSucceed	关卡【{0}】恢复记录成功
BabelTowerStageShowDesc	最高战略等级：{0}
